1111111111111
1001000C00001
1000011010001
1P001110E0001
1111111111111